==========================
!     *  X  =   T  W     =
*     *     =            =
      ******=            =
  M    ^    = K          =
            =            =
            #!           =
            =   ^        =
======      =            =
X    =      =            =
@    =      =            =
==========================