==========================
  T  =      @    =   K   =
     =           =       =
     =           =*******=
     ======#======       =
                W        =
                         =
                         =
                         =
                      M  =
=====                    =
!   =                    =
*   =                    =
X   =                 X  =
==========================