==========================
! X  =        T  W  X    =
*****====#====           =
             =  ^ !      =
  M      ^   =    K      =
    ****     =============
    * @*                 =
    ****        ^        =
                         =
==========================